--------------------------------------------------------------------------------------------------------------------------------------------------------------------------------------------------------
--------------------------------------------------------------------------------------------------------------------------------------------------------------------------------------------------------
--------------------------------------------------------------------------------------------------------------------------------------------------------------------------------------------------------
----------------XXXXXXXX-------------------------------------------------------------------------------------------------------------------------o------------------------------------------------------
------------------------------------------------------------------------------o-------------------------------------------------------------------------------------------------------------------------
--------------------------------------------------------------------------------------------------------------------------------------------------------------------------------------------------------
---------------------------------------------------------------------------------------------------------------------------------------------------------------XX--------------------------????---------
-------------------------------------------------------------------------------------------------------------------------------------------------------------------------------------------------------v
-------------------------------------------------------------------------------------------------------------------------------------------------------------------------------------------------------f
-------------------------------------------------------------------------------------------------------XXX---------------------------------------------------------------------------------------------f
--------?---------------------------------------------------------------------------------------------------------------------------------------BBBB---B-----------------------------------------------f
---------------X----------------------------------------------------------------------------------------------------------------T---------------------------------o--------------------o---------------f
--------------XX-------------------------X--------------------------------------------------------------------------------------|----------------------------------------------------------------------f
-------------XXX------------------------XX--------------------------------------------------------------------------------------|-----------------------------------------------------------??---------f
m---XE------XXXX-----------------------XXX--------------------------------------------------------------------------------------|----------------------------------------------------E----------E------X
XXXX---XXX-XXXXX--XXXXXXXXXXXXXXXXXXXXXXXXXXXXXXXXXXXXXXXXXXXXXXXXXXXXXXXXXXXXXXXXXXXXXXXXXXXXXXXXXXXXXXXXXXXXXXXXXXXXXXXXXXXXXX|XXXXXXXXXXXXXXXXXXXXX-XXXXXXXXXXXXXXXXXXXXXXXXXXXXXXXXXXXXXXXXXXXXXXXXX
