---------------------------o-------------------------------------------------------------------M--------------------------------------------------------------------------------------------------------
--------------------------------------------------------------------------------------------------------------------------------------------------------------------------------------------------------
----------------------------------------------------------------------------------------------BB--------------------------------------------B-----------------------------------------------------------
---B---------------------X------------------------------------------------------------------------------------------------------------------------------------------------------------------------------
--------------o--X------------------------------------------------------------o-------------------------------------------------------------------------------------------------------------------------
-----------------------------------------------------------------------o--------------------------------------------------------------------------------------------------------------------------------
----------------X----------------------------------------------------------------------------------------------------------------------------------------------XX--------------------------????---------
----------------XX---------------------------------------------------------------------------------------------------------------------------------------------M---------------------------------------v
----------------XXX-------------------------------X--B-------------------------------------------------------------------------------------------------------------------------------------------------f
----------------XXXX---------------?-------------TX----------------------------------------------------XXX---------------------------------------------------------------------------------------------f
---------------?XXXXX--------------------------?X|X??-------------------------------------------------------------------------------------------BBBB---B-----------------------------------------------f
----------------XXXXXX-------------------------XX|X-------------------------------------------------T---------------------------T---------------------------------o-------------------------------?----f
----------------XXXXXXX-----------------------XXX|X----------------------------XXXX-----------------|---------------------------|----------------------------------------------------------------------f
----------------XXXXXXXX---------------------XXXX|X------------------------------XX-----------------|------T--------------------|-------------------T-------------------------------o-------??---------f
m-------------X-XXXXXXXXX-------------------XXXXX|X-----------------------------XXX-----------------|-----E|--------------------|--------E----------|----E-------------------o-E-----E----------E------X
XXXXXXXXXXXXXXXXXXXXXXXXXXXXXXXXXXXXXXXXXXXXXXXXX|X-XXXXXXXXXXXXXXXXXXXXXXXXXXXXXXXXX------XXXXXXXXX|XXXXXX|XXXXX------XXXXXXXXX|XXXXXXXXXXXXXXXXXXX|X-XXXXXXXXXXXXXXXXXXXXX---------XXXXXX----X-----XXX
