--------------------------------------------------------------------------------------------------------------------------------------------------------------------------------------------------------
--------------------------------------------------------------------------------------------------------------------------------------------------------------------------------------------------------
-----------------------------------------------------------------------------------------------------------------------------------------------------------------------------------o--------------------
--------------------------------------------------------------------------------------------------------------------------------------------------------------------------------------------------------
--------------------------------------------------------------------------------------------------------------------------------------------------------------------------------------------------------
--------------------------------------------------------------------------------------------------------------------------------------------------------------------------------------------------------
--------------------------------------------------------------------------------------------------------------------------------------------------------------------------------------------------------
--------------------------------------------------------------o----------------------------------------------------------------------------------------------------------------------------------------v
--------------------------------------------------------------------------------------------------------------------------------------------------------------------------------------------o-----T----f
--------------------------------------------------------------------------------------------------------------------------------------------------------------------------------------------------|BBBBf
-----------------------------------------------------------------------------X--------------------------------------------------------------------------------------------------------------------|----f
----------------------------------------------------------------------------XX-------------------------------------------------------------------------------------------o------------------------|----f
---------------------------------------------------------------------------XXX------------------------------------------------------------------------------------------------------------------T-|----f
--------------------------------------------------------------------------XXXX------------------------------------------------------------------------------------------------------------------|-|----f
m----------------E-------------------------------------------------------XXXXX----------------------------------------------------------------------------------EE------------------------E-----|-|----X
XXXXXXXXXXXXXXXXXXXXXXXXXXXXXXXXXXXXXXXXXXXXXXXXXXXXXXXXXXXXXXXXXX------XXXXXXXXXXXXXXXXXXXXXXXXXXXXXXXXXXXXXXXXXXXXXXXXXXXXXXXXXXXXXXXXXXXXXXXXXXXXXXXXXXXXXXXXXXXXXXXXXXXXXXXXXXXX-----X-----X|X|----X
