---o----------------------------------------------------------------------------------------------------------------------------------------------------------------------------------------------------
------------------------------------------------------------------------------------------------------------------------------------------------------------------------------?-------------------------
--------------------------------------------------------------------------------------------------------------------------------------------------------------------------------------------------------
--------------------------------------------------------------------------------------------------------------------------------------------------------------------------------------------------B-----
-------B------------------------------------------------------------------------------------------------------------------------------------------------------------------------------------------------
--T-----------------------------------------------------------------------------------------------------------------------------------------------------------------------------------------------------
--|-------------------------------------------------------------------------------------------------------------------------------------------------------------------------------------M---------------
--|----------------------------------------------------------------------------------------------------------------------------------------------------------------------------------------------------v
--|----------------------------------------------------------------------------------------------------------------------------------------------------------------------------------------------------f
--|--------------------------------------------------------------------------------------------------------------------------------------------------------------------M-------------------------------f
--|----------------------------------------------------------------------------------------------------------------------------------------------------------------------------------------------------f
--|-------------------------------------------------------------------------------------------------------------------------------------------------------------------------------BBBBBB---------------f
--|-------------------------------------------------------M--------------------------------------------------------------------------------------------------------------T-----------------------------f
--|----------------------------------------------------------------------------------------------------------------------------------------------------------------------|------????-------------------f
m-|E-------------------------------------------------------------------------------------------------------------------------------------------------------------E-------|------------------E----------X
XX|XX-XXXXXXXXXXXXXXXXXXXXXXXXXXXXXXXXXXXXXXXXXXXXXXXXXXXXXXXXXXXXXXXXXXXXXXXXXXXXXXXXXXXXXXXXXXXXXXXXXXXXXXXXXXXXXXXXXXXXXXXXXXXXXXXXXXXXXXXXXXXXXXXXXXXXXXXXXXXXXXXXXXX|XXXXXXXXXXXXX------XXXXXXXXXXX
